    SO  ./asset/wall/walls.xpm
     F 100      ,100          ,        100



  WE ./asset/wall/wallw.xpm
EA ./asset/wall/walle.xpm


NO        ./asset/wall/walln.xpm

           C                          00,30,200

DOOR ./asset/door/door.xpm




11111111111111111
10010000000000001
10010000000000001
10010000000000001
10010000000W00001
100V0000000000001
10010000000000001
10010000000000001
10011H11100000001
10000000100000001
11111111111111111


