    SO  ./asset/wall/walls.xpm
     F 100      ,100          ,        100

  WE ./asset/wall/wallw.xpm
EA ./asset/wall/walle.xpm


NO        ./asset/wall/walln.xpm



           C                          00,30,200




11111111111111111
10010000000000001
10010000000000001
10010000000000001
10010000000W00001
10010000000000001
10010000000000001  111
10010000000000001  101
10011011100000001  111
10000000100000001
11111111111111111

    111
