1111111111111111111111111
100000000000C0000000000M1
1000000000111110000000001
1C000000M000000M0000000C1
1110000110000000110000111
1000C0000000C0000M00C0001
10000000000M0000000000001
1000111100000000011110001
1000000000000000000000001
1000000000111110000000001
1P000000000M00000000000E1
1111111111111111111111111
