1111111
100C001
1M00001
1P000E1
1111111
