1111111
1000000
1000001
1PEC001
1111111
